1111111111111111111111111111111111111
1100C10000000000000000000111111111111
1000010000000000000000000111111111111
1001E10C00000000000000000111111000001
1100000000000000000000000111111000001
11111C10000000C0000000000111111000001
100000CC00000000000000000110111111111
1000000000000111111111111111111111111
1000000000C0P000000000000111111111111
1111111111111111111111111111111111111
